########
#A.H..G#
#.####.#
#......#
#..O...#
########
