########
#A..H.G#
#.####.#
#......#
########
