########
#A.H..G#
#.####.#
#..O...#
########
